.......................
...............VVV.....
..VVV..................
.......................
.......................
----....----...^^^^----
