#########################
#.......................#
#...............VVV.....#
#..VVV..................#
#.......................#
#.......................#
#----....----...^^^^----#
#########################
