.......................
...............VVV.....
..VVV....^VV^V.........
.......................
.......................
----^^^^----...^^^^----
