....................................................................................
....................................................................................
....................................................................................
....................................................................................
....................................................................................
....................................................................................
....................................................................................
....................................................................................
....................................................................................
....................................................................................
....................................................................................
....................................................................................
....................................................................................
....................................................................................
....................................................................................
....................................................................................
C............^^^.......^^^...........^^^^^^............^^^..................^.^..^..
------------------------------------------------------------------------------------
